NO ./textures/horror/north.xpm
          SO      ./textures/horror/south.xpm
WE          ./textures/horror/west.xpm
       EA       ./textures/horror/east.xpm

        F 80,70,70
  C        0,0,0



        11111111111 11111111111111
        10000000001110000000000001
        1011000001110000000000001
        1001000000000000000000001
11111111101100000111000000000001
1000000D001100000111011111111111
1111D111111111011100000010001
111101111111111 11101010010111
 1000000000001111000000100001
1000000000000000110000001001
100N0000000000001101010010001
1100000111010101111101111000111
11110111110101011111111010001
  1111111111111111 111111111111
