NO ./textures/wolfenstein/north.xpm
          SO      ./textures/wolfenstein/south.xpm
WE          ./textures/wolfenstein/west.xpm
       EA       ./textures/wolfenstein/east.xpm

        F 80,70,70
  C        65,105,225



        11111111111 11111111111111
        10000000001110000000000001
        1011000001110000000000001
        1001000000000000000000001
11111111101100000111000000000001
10000000001100000111011111111111
11110111111111011100000010001
111101111111111 11101010010111
 1000000000001111000000100001
100000N000000000110000001001
10000000000000001101010010001
1100000111010101111101111000111
11110111110101011111111010001
  1111111111111111 111111111111
