NO ./quelquechose.xpm
          SO      jsp.xpm
WE          ./coucou.xpm
       EA       ./bonjour.xpm

        F 80,70,70
  C        65,105,225

        11111111111 1111111111111
        10000000001110000000000001
        1011000001110000000000001
        1001000000000000000000001
111111111011000001110000000000001
100000000011000001110111111111111
11110111111111011100000010001
111101111111111 11101010010001
1000000111101011100000010001
10000000000000001100000010001
10000000000000001101010010001
11000001110101011111011110N0111
11110111110101011111111010001
  1111111111111111 111111111111
