NO ./textures/north.xpm
          SO      ./textures/south.xpm
WE          ./textures/west.xpm
       EA       ./textures/east.xpm

        F 80,70,70
  C        65,105,225

        11111111111 1111111111111
        10000000001110000000000001
        1011000001110000000000001
        1001000000000000000000001
11111111101100000111000000000001
100000000011000001110111111111111
11110111111111011100000010001
111101111111111 11101010010001
10000000000010111000000100011
10000000000000001100000010001
1000000000N000001101010010001
1100000111010101111101111000111
11110111110101011111111010001
  1111111111111111 111111111111
