NO ./quelquechose.xpm
          SO      jsp.xpm
WE          ./coucou.xpm
       EA       ./bonjour.xpm

        F 240,50,0
  C        225,30,0

        11111111111 1111111111111
        10000000001110000000000001
        1011000001110000000000001
        1001000000000000000000001
111111111011000001110000000000001
100000000011000001110111111111111
11110111111111011100000010001
11110111111111011101010010001
1000000111101011100000010001
10000000000000001100000010001
10000000000000001101010010001
11000001110101011111011110N0111
11110111110101011111111010001
  1111111111111111 111111111111
